01000000000000000000
01111111111101101110
01001001000111000010
01100011101101111000
01001000101000010010
01011010100011011010
01111110111001110000
00001000001011010011
01101101111100001010
00100001000010000000
