01000000000000000000
01111110111111111110
01001010100000101010
01111111111100111010
00000000000000001010
01111000101111101110
01001111101010011010
01000001001011100010
11111101111010111110
00000000000000000000
