01000000001000000000
01111110001011111110
01010010001010101010
01111110101110101010
01000000101000101010
01111000101111101010
00001111110000011010
00001000011111110010
01111000111001000110
00000000000000000000
